"filename", "language", "vue", "XML", "CSS", "JavaScript", "comment", "blank", "total"
"d:\Training-workspace\project-ws\loop-code-plus_vue_5\project\loop-code-plus-vue-5\src\App.vue", "vue", 8, 0, 0, 0, 0, 4, 12
"d:\Training-workspace\project-ws\loop-code-plus_vue_5\project\loop-code-plus-vue-5\src\api\store.js", "JavaScript", 0, 0, 0, 10, 1, 1, 12
"d:\Training-workspace\project-ws\loop-code-plus_vue_5\project\loop-code-plus-vue-5\src\api\user.js", "JavaScript", 0, 0, 0, 8, 1, 1, 10
"d:\Training-workspace\project-ws\loop-code-plus_vue_5\project\loop-code-plus-vue-5\src\assets\icon\MaterialSymbolsBackpackOutlineRounded.svg", "XML", 0, 1, 0, 0, 0, 0, 1
"d:\Training-workspace\project-ws\loop-code-plus_vue_5\project\loop-code-plus-vue-5\src\assets\icon\MaterialSymbolsBarChartRounded.svg", "XML", 0, 1, 0, 0, 0, 0, 1
"d:\Training-workspace\project-ws\loop-code-plus_vue_5\project\loop-code-plus-vue-5\src\assets\icon\MaterialSymbolsClarifyOutlineRounded.svg", "XML", 0, 1, 0, 0, 0, 0, 1
"d:\Training-workspace\project-ws\loop-code-plus_vue_5\project\loop-code-plus-vue-5\src\assets\icon\MaterialSymbolsContractEditRounded.svg", "XML", 0, 1, 0, 0, 0, 0, 1
"d:\Training-workspace\project-ws\loop-code-plus_vue_5\project\loop-code-plus-vue-5\src\assets\icon\MaterialSymbolsExitToAppRounded.svg", "XML", 0, 1, 0, 0, 0, 0, 1
"d:\Training-workspace\project-ws\loop-code-plus_vue_5\project\loop-code-plus-vue-5\src\assets\icon\MaterialSymbolsInfoOutlineRounded.svg", "XML", 0, 1, 0, 0, 0, 0, 1
"d:\Training-workspace\project-ws\loop-code-plus_vue_5\project\loop-code-plus-vue-5\src\assets\icon\MaterialSymbolsMarkChatReadOutlineRounded.svg", "XML", 0, 1, 0, 0, 0, 0, 1
"d:\Training-workspace\project-ws\loop-code-plus_vue_5\project\loop-code-plus-vue-5\src\assets\icon\MaterialSymbolsMarkdownCopyOutlineRounded.svg", "XML", 0, 1, 0, 0, 0, 0, 1
"d:\Training-workspace\project-ws\loop-code-plus_vue_5\project\loop-code-plus-vue-5\src\assets\icon\MaterialSymbolsMilitaryTechOutlineRounded.svg", "XML", 0, 1, 0, 0, 0, 0, 1
"d:\Training-workspace\project-ws\loop-code-plus_vue_5\project\loop-code-plus-vue-5\src\assets\icon\MaterialSymbolsRewardedAdsOutlineRounded.svg", "XML", 0, 1, 0, 0, 0, 0, 1
"d:\Training-workspace\project-ws\loop-code-plus_vue_5\project\loop-code-plus-vue-5\src\assets\icon\MaterialSymbolsTerminalRounded.svg", "XML", 0, 1, 0, 0, 0, 0, 1
"d:\Training-workspace\project-ws\loop-code-plus_vue_5\project\loop-code-plus-vue-5\src\assets\icon\MaterialSymbolsTollOutlineRounded.svg", "XML", 0, 1, 0, 0, 0, 0, 1
"d:\Training-workspace\project-ws\loop-code-plus_vue_5\project\loop-code-plus-vue-5\src\assets\icon\MaterialSymbolsTrophyOutline.svg", "XML", 0, 1, 0, 0, 0, 0, 1
"d:\Training-workspace\project-ws\loop-code-plus_vue_5\project\loop-code-plus-vue-5\src\assets\icon\MaterialSymbolsVerifiedOutline.svg", "XML", 0, 1, 0, 0, 0, 0, 1
"d:\Training-workspace\project-ws\loop-code-plus_vue_5\project\loop-code-plus-vue-5\src\components\Header.vue", "vue", 369, 0, 0, 0, 0, 6, 375
"d:\Training-workspace\project-ws\loop-code-plus_vue_5\project\loop-code-plus-vue-5\src\https\request.js", "JavaScript", 0, 0, 0, 7, 0, 3, 10
"d:\Training-workspace\project-ws\loop-code-plus_vue_5\project\loop-code-plus-vue-5\src\main.js", "JavaScript", 0, 0, 0, 16, 5, 5, 26
"d:\Training-workspace\project-ws\loop-code-plus_vue_5\project\loop-code-plus-vue-5\src\router\index.js", "JavaScript", 0, 0, 0, 121, 1, 5, 127
"d:\Training-workspace\project-ws\loop-code-plus_vue_5\project\loop-code-plus-vue-5\src\store\user.js", "JavaScript", 0, 0, 0, 22, 2, 1, 25
"d:\Training-workspace\project-ws\loop-code-plus_vue_5\project\loop-code-plus-vue-5\src\style.css", "CSS", 0, 0, 63, 0, 7, 9, 79
"d:\Training-workspace\project-ws\loop-code-plus_vue_5\project\loop-code-plus-vue-5\src\view\Competition.vue", "vue", 614, 0, 0, 0, 1, 14, 629
"d:\Training-workspace\project-ws\loop-code-plus_vue_5\project\loop-code-plus-vue-5\src\view\Course.vue", "vue", 25, 0, 0, 0, 0, 4, 29
"d:\Training-workspace\project-ws\loop-code-plus_vue_5\project\loop-code-plus-vue-5\src\view\Home.vue", "vue", 581, 0, 0, 0, 0, 15, 596
"d:\Training-workspace\project-ws\loop-code-plus_vue_5\project\loop-code-plus-vue-5\src\view\Library.vue", "vue", 493, 0, 0, 0, 1, 8, 502
"d:\Training-workspace\project-ws\loop-code-plus_vue_5\project\loop-code-plus-vue-5\src\view\Library\python\Python-basicSyntax.vue", "vue", 9, 0, 0, 0, 0, 4, 13
"d:\Training-workspace\project-ws\loop-code-plus_vue_5\project\loop-code-plus-vue-5\src\view\Library\python\Python-calculator.vue", "vue", 9, 0, 0, 0, 0, 4, 13
"d:\Training-workspace\project-ws\loop-code-plus_vue_5\project\loop-code-plus-vue-5\src\view\Library\python\Python-class.vue", "vue", 9, 0, 0, 0, 0, 4, 13
"d:\Training-workspace\project-ws\loop-code-plus_vue_5\project\loop-code-plus-vue-5\src\view\Library\python\Python-comment.vue", "vue", 9, 0, 0, 0, 0, 4, 13
"d:\Training-workspace\project-ws\loop-code-plus_vue_5\project\loop-code-plus-vue-5\src\view\Library\python\Python-controller.vue", "vue", 9, 0, 0, 0, 0, 4, 13
"d:\Training-workspace\project-ws\loop-code-plus_vue_5\project\loop-code-plus-vue-5\src\view\Library\python\Python-dataStructure.vue", "vue", 9, 0, 0, 0, 0, 4, 13
"d:\Training-workspace\project-ws\loop-code-plus_vue_5\project\loop-code-plus-vue-5\src\view\Library\python\Python-error.vue", "vue", 9, 0, 0, 0, 0, 4, 13
"d:\Training-workspace\project-ws\loop-code-plus_vue_5\project\loop-code-plus-vue-5\src\view\Library\python\Python-inputAndOuput.vue", "vue", 9, 0, 0, 0, 0, 4, 13
"d:\Training-workspace\project-ws\loop-code-plus_vue_5\project\loop-code-plus-vue-5\src\view\Library\python\Python-install.vue", "vue", 31, 0, 0, 0, 0, 2, 33
"d:\Training-workspace\project-ws\loop-code-plus_vue_5\project\loop-code-plus-vue-5\src\view\Library\python\Python-interpreter.vue", "vue", 9, 0, 0, 0, 0, 4, 13
"d:\Training-workspace\project-ws\loop-code-plus_vue_5\project\loop-code-plus-vue-5\src\view\Library\python\Python-introduction.vue", "vue", 9, 0, 0, 0, 0, 4, 13
"d:\Training-workspace\project-ws\loop-code-plus_vue_5\project\loop-code-plus-vue-5\src\view\Library\python\Python-module.vue", "vue", 9, 0, 0, 0, 0, 4, 13
"d:\Training-workspace\project-ws\loop-code-plus_vue_5\project\loop-code-plus-vue-5\src\view\Library\python\Python-next.vue", "vue", 9, 0, 0, 0, 0, 4, 13
"d:\Training-workspace\project-ws\loop-code-plus_vue_5\project\loop-code-plus-vue-5\src\view\Library\python\Python-standardLibrary.vue", "vue", 9, 0, 0, 0, 0, 4, 13
"d:\Training-workspace\project-ws\loop-code-plus_vue_5\project\loop-code-plus-vue-5\src\view\Library\python\Python.vue", "vue", 108, 0, 0, 0, 0, 3, 111
"d:\Training-workspace\project-ws\loop-code-plus_vue_5\project\loop-code-plus-vue-5\src\view\Library\python\install\Install-Windows.vue", "vue", 731, 0, 0, 0, 0, 6, 737
"d:\Training-workspace\project-ws\loop-code-plus_vue_5\project\loop-code-plus-vue-5\src\view\Problem.vue", "vue", 373, 0, 0, 0, 0, 8, 381
"d:\Training-workspace\project-ws\loop-code-plus_vue_5\project\loop-code-plus-vue-5\src\view\Search.vue", "vue", 158, 0, 0, 0, 0, 8, 166
"d:\Training-workspace\project-ws\loop-code-plus_vue_5\project\loop-code-plus-vue-5\src\view\Store.vue", "vue", 222, 0, 0, 0, 0, 5, 227
"d:\Training-workspace\project-ws\loop-code-plus_vue_5\project\loop-code-plus-vue-5\src\view\problem\WorkingArea.vue", "vue", 308, 0, 0, 0, 0, 7, 315
"d:\Training-workspace\project-ws\loop-code-plus_vue_5\project\loop-code-plus-vue-5\src\view\tool\EditProblem.vue", "vue", 285, 0, 0, 0, 0, 8, 293
"d:\Training-workspace\project-ws\loop-code-plus_vue_5\project\loop-code-plus-vue-5\src\view\tool\LCPlab.vue", "vue", 32, 0, 0, 0, 0, 5, 37
"d:\Training-workspace\project-ws\loop-code-plus_vue_5\project\loop-code-plus-vue-5\src\view\tool\Login.vue", "vue", 267, 0, 0, 0, 0, 17, 284
"d:\Training-workspace\project-ws\loop-code-plus_vue_5\project\loop-code-plus-vue-5\src\view\tool\MyProblem.vue", "vue", 279, 0, 0, 0, 0, 4, 283
"d:\Training-workspace\project-ws\loop-code-plus_vue_5\project\loop-code-plus-vue-5\src\view\tool\MySolution.vue", "vue", 6, 0, 0, 0, 0, 5, 11
"Total", "-", 5007, 14, 63, 184, 19, 206, 5493