"filename", "language", "JavaScript", "vue", "comment", "blank", "total"
"d:\Training-workspace\project-ws\loop-code-plus_vue_5\project\loop-code-plus-vue-5\src\api\competition.js", "JavaScript", 0, 0, 0, 2, 2
"d:\Training-workspace\project-ws\loop-code-plus_vue_5\project\loop-code-plus-vue-5\src\api\home.js", "JavaScript", 8, 0, 1, 0, 9
"d:\Training-workspace\project-ws\loop-code-plus_vue_5\project\loop-code-plus-vue-5\src\api\myProblem.js", "JavaScript", 9, 0, 1, 0, 10
"d:\Training-workspace\project-ws\loop-code-plus_vue_5\project\loop-code-plus-vue-5\src\api\problem.js", "JavaScript", 6, 0, 1, 0, 7
"d:\Training-workspace\project-ws\loop-code-plus_vue_5\project\loop-code-plus-vue-5\src\components\Header.vue", "vue", 0, -18, 0, 2, -16
"d:\Training-workspace\project-ws\loop-code-plus_vue_5\project\loop-code-plus-vue-5\src\https\websocket.js", "JavaScript", 2, 0, 0, 0, 2
"d:\Training-workspace\project-ws\loop-code-plus_vue_5\project\loop-code-plus-vue-5\src\router\index.js", "JavaScript", 12, 0, 0, 0, 12
"d:\Training-workspace\project-ws\loop-code-plus_vue_5\project\loop-code-plus-vue-5\src\store\competition.js", "JavaScript", 18, 0, 2, 1, 21
"d:\Training-workspace\project-ws\loop-code-plus_vue_5\project\loop-code-plus-vue-5\src\store\user.js", "JavaScript", 14, 0, 0, 0, 14
"d:\Training-workspace\project-ws\loop-code-plus_vue_5\project\loop-code-plus-vue-5\src\view\Competition.vue", "vue", 0, 14, 0, 2, 16
"d:\Training-workspace\project-ws\loop-code-plus_vue_5\project\loop-code-plus-vue-5\src\view\Home.vue", "vue", 0, 24, 0, 2, 26
"d:\Training-workspace\project-ws\loop-code-plus_vue_5\project\loop-code-plus-vue-5\src\view\Library\python\Python-introduction.vue", "vue", 0, 14, 0, 0, 14
"d:\Training-workspace\project-ws\loop-code-plus_vue_5\project\loop-code-plus-vue-5\src\view\PersonalCenter\info.vue", "vue", 0, 419, 0, 29, 448
"d:\Training-workspace\project-ws\loop-code-plus_vue_5\project\loop-code-plus-vue-5\src\view\Problem.vue", "vue", 0, 19, 0, 1, 20
"d:\Training-workspace\project-ws\loop-code-plus_vue_5\project\loop-code-plus-vue-5\src\view\problem\Collection.vue", "vue", 0, 318, 0, 11, 329
"d:\Training-workspace\project-ws\loop-code-plus_vue_5\project\loop-code-plus-vue-5\src\view\problem\SingCompetitionArea.vue", "vue", 0, 93, 0, 4, 97
"d:\Training-workspace\project-ws\loop-code-plus_vue_5\project\loop-code-plus-vue-5\src\view\problem\WorkingArea.vue", "vue", 0, 5, 0, 3, 8
"d:\Training-workspace\project-ws\loop-code-plus_vue_5\project\loop-code-plus-vue-5\src\view\tool\Achievement.vue", "vue", 0, 626, 0, 25, 651
"d:\Training-workspace\project-ws\loop-code-plus_vue_5\project\loop-code-plus-vue-5\src\view\tool\Backpack.vue", "vue", 0, 2, 0, 1, 3
"d:\Training-workspace\project-ws\loop-code-plus_vue_5\project\loop-code-plus-vue-5\src\view\tool\EditCollection.vue", "vue", 0, 11, 0, 0, 11
"d:\Training-workspace\project-ws\loop-code-plus_vue_5\project\loop-code-plus-vue-5\src\view\tool\EditProblem.vue", "vue", 0, 1, 0, 0, 1
"d:\Training-workspace\project-ws\loop-code-plus_vue_5\project\loop-code-plus-vue-5\src\view\tool\LCPlab.vue", "vue", 0, 11, 0, 0, 11
"d:\Training-workspace\project-ws\loop-code-plus_vue_5\project\loop-code-plus-vue-5\src\view\tool\Login.vue", "vue", 0, 4, 0, 1, 5
"d:\Training-workspace\project-ws\loop-code-plus_vue_5\project\loop-code-plus-vue-5\src\view\tool\MyProblem.vue", "vue", 0, 4, 0, 0, 4
"d:\Training-workspace\project-ws\loop-code-plus_vue_5\project\loop-code-plus-vue-5\src\view\tool\PersonalCenter.vue", "vue", 0, 265, 0, 31, 296
"Total", "-", 69, 1812, 5, 115, 2001