"filename", "language", "JavaScript", "CSS", "vue", "XML", "comment", "blank", "total"
"d:\Training-workspace\project-ws\loop-code-plus_vue_5\project\loop-code-plus-vue-5\src\App.vue", "vue", 0, 0, 8, 0, 0, 4, 12
"d:\Training-workspace\project-ws\loop-code-plus_vue_5\project\loop-code-plus-vue-5\src\api\competition.js", "JavaScript", 25, 0, 0, 0, 0, 6, 31
"d:\Training-workspace\project-ws\loop-code-plus_vue_5\project\loop-code-plus-vue-5\src\api\header.js", "JavaScript", 7, 0, 0, 0, 1, 1, 9
"d:\Training-workspace\project-ws\loop-code-plus_vue_5\project\loop-code-plus-vue-5\src\api\home.js", "JavaScript", 8, 0, 0, 0, 1, 1, 10
"d:\Training-workspace\project-ws\loop-code-plus_vue_5\project\loop-code-plus-vue-5\src\api\myProblem.js", "JavaScript", 84, 0, 0, 0, 9, 1, 94
"d:\Training-workspace\project-ws\loop-code-plus_vue_5\project\loop-code-plus-vue-5\src\api\problem.js", "JavaScript", 20, 0, 0, 0, 2, 4, 26
"d:\Training-workspace\project-ws\loop-code-plus_vue_5\project\loop-code-plus-vue-5\src\api\solution.js", "JavaScript", 30, 0, 0, 0, 3, 3, 36
"d:\Training-workspace\project-ws\loop-code-plus_vue_5\project\loop-code-plus-vue-5\src\api\store.js", "JavaScript", 10, 0, 0, 0, 1, 1, 12
"d:\Training-workspace\project-ws\loop-code-plus_vue_5\project\loop-code-plus-vue-5\src\api\user.js", "JavaScript", 15, 0, 0, 0, 2, 2, 19
"d:\Training-workspace\project-ws\loop-code-plus_vue_5\project\loop-code-plus-vue-5\src\api\workingArea.js", "JavaScript", 28, 0, 0, 0, 3, 1, 32
"d:\Training-workspace\project-ws\loop-code-plus_vue_5\project\loop-code-plus-vue-5\src\assets\icon\MaterialSymbolsBackpackOutlineRounded.svg", "XML", 0, 0, 0, 1, 0, 0, 1
"d:\Training-workspace\project-ws\loop-code-plus_vue_5\project\loop-code-plus-vue-5\src\assets\icon\MaterialSymbolsBarChartRounded.svg", "XML", 0, 0, 0, 1, 0, 0, 1
"d:\Training-workspace\project-ws\loop-code-plus_vue_5\project\loop-code-plus-vue-5\src\assets\icon\MaterialSymbolsClarifyOutlineRounded.svg", "XML", 0, 0, 0, 1, 0, 0, 1
"d:\Training-workspace\project-ws\loop-code-plus_vue_5\project\loop-code-plus-vue-5\src\assets\icon\MaterialSymbolsContractEditRounded.svg", "XML", 0, 0, 0, 1, 0, 0, 1
"d:\Training-workspace\project-ws\loop-code-plus_vue_5\project\loop-code-plus-vue-5\src\assets\icon\MaterialSymbolsExitToAppRounded.svg", "XML", 0, 0, 0, 1, 0, 0, 1
"d:\Training-workspace\project-ws\loop-code-plus_vue_5\project\loop-code-plus-vue-5\src\assets\icon\MaterialSymbolsInfoOutlineRounded.svg", "XML", 0, 0, 0, 1, 0, 0, 1
"d:\Training-workspace\project-ws\loop-code-plus_vue_5\project\loop-code-plus-vue-5\src\assets\icon\MaterialSymbolsMarkChatReadOutlineRounded.svg", "XML", 0, 0, 0, 1, 0, 0, 1
"d:\Training-workspace\project-ws\loop-code-plus_vue_5\project\loop-code-plus-vue-5\src\assets\icon\MaterialSymbolsMarkdownCopyOutlineRounded.svg", "XML", 0, 0, 0, 1, 0, 0, 1
"d:\Training-workspace\project-ws\loop-code-plus_vue_5\project\loop-code-plus-vue-5\src\assets\icon\MaterialSymbolsMilitaryTechOutlineRounded.svg", "XML", 0, 0, 0, 1, 0, 0, 1
"d:\Training-workspace\project-ws\loop-code-plus_vue_5\project\loop-code-plus-vue-5\src\assets\icon\MaterialSymbolsRewardedAdsOutlineRounded.svg", "XML", 0, 0, 0, 1, 0, 0, 1
"d:\Training-workspace\project-ws\loop-code-plus_vue_5\project\loop-code-plus-vue-5\src\assets\icon\MaterialSymbolsTerminalRounded.svg", "XML", 0, 0, 0, 1, 0, 0, 1
"d:\Training-workspace\project-ws\loop-code-plus_vue_5\project\loop-code-plus-vue-5\src\assets\icon\MaterialSymbolsTollOutlineRounded.svg", "XML", 0, 0, 0, 1, 0, 0, 1
"d:\Training-workspace\project-ws\loop-code-plus_vue_5\project\loop-code-plus-vue-5\src\assets\icon\MaterialSymbolsTrophyOutline.svg", "XML", 0, 0, 0, 1, 0, 0, 1
"d:\Training-workspace\project-ws\loop-code-plus_vue_5\project\loop-code-plus-vue-5\src\assets\icon\MaterialSymbolsVerifiedOutline.svg", "XML", 0, 0, 0, 1, 0, 0, 1
"d:\Training-workspace\project-ws\loop-code-plus_vue_5\project\loop-code-plus-vue-5\src\components\Header.vue", "vue", 0, 0, 356, 0, 0, 9, 365
"d:\Training-workspace\project-ws\loop-code-plus_vue_5\project\loop-code-plus-vue-5\src\https\request.js", "JavaScript", 6, 0, 0, 0, 0, 3, 9
"d:\Training-workspace\project-ws\loop-code-plus_vue_5\project\loop-code-plus-vue-5\src\https\requestWI.js", "JavaScript", 59, 0, 0, 0, 10, 4, 73
"d:\Training-workspace\project-ws\loop-code-plus_vue_5\project\loop-code-plus-vue-5\src\https\websocket.js", "JavaScript", 3, 0, 0, 0, 0, 0, 3
"d:\Training-workspace\project-ws\loop-code-plus_vue_5\project\loop-code-plus-vue-5\src\main.js", "JavaScript", 16, 0, 0, 0, 5, 5, 26
"d:\Training-workspace\project-ws\loop-code-plus_vue_5\project\loop-code-plus-vue-5\src\router\index.js", "JavaScript", 161, 0, 0, 0, 1, 5, 167
"d:\Training-workspace\project-ws\loop-code-plus_vue_5\project\loop-code-plus-vue-5\src\store\competition.js", "JavaScript", 18, 0, 0, 0, 2, 1, 21
"d:\Training-workspace\project-ws\loop-code-plus_vue_5\project\loop-code-plus-vue-5\src\store\controller.js", "JavaScript", 14, 0, 0, 0, 2, 1, 17
"d:\Training-workspace\project-ws\loop-code-plus_vue_5\project\loop-code-plus-vue-5\src\store\user.js", "JavaScript", 50, 0, 0, 0, 2, 1, 53
"d:\Training-workspace\project-ws\loop-code-plus_vue_5\project\loop-code-plus-vue-5\src\store\websocket.js", "JavaScript", 15, 0, 0, 0, 2, 2, 19
"d:\Training-workspace\project-ws\loop-code-plus_vue_5\project\loop-code-plus-vue-5\src\style.css", "CSS", 0, 78, 0, 0, 7, 9, 94
"d:\Training-workspace\project-ws\loop-code-plus_vue_5\project\loop-code-plus-vue-5\src\view\Competition.vue", "vue", 0, 0, 681, 0, 1, 19, 701
"d:\Training-workspace\project-ws\loop-code-plus_vue_5\project\loop-code-plus-vue-5\src\view\Course.vue", "vue", 0, 0, 215, 0, 0, 8, 223
"d:\Training-workspace\project-ws\loop-code-plus_vue_5\project\loop-code-plus-vue-5\src\view\Course\CourseInfo.vue", "vue", 0, 0, 221, 0, 0, 4, 225
"d:\Training-workspace\project-ws\loop-code-plus_vue_5\project\loop-code-plus-vue-5\src\view\Home.vue", "vue", 0, 0, 605, 0, 0, 17, 622
"d:\Training-workspace\project-ws\loop-code-plus_vue_5\project\loop-code-plus-vue-5\src\view\Library.vue", "vue", 0, 0, 493, 0, 1, 8, 502
"d:\Training-workspace\project-ws\loop-code-plus_vue_5\project\loop-code-plus-vue-5\src\view\Library\python\Python-basicSyntax.vue", "vue", 0, 0, 9, 0, 0, 4, 13
"d:\Training-workspace\project-ws\loop-code-plus_vue_5\project\loop-code-plus-vue-5\src\view\Library\python\Python-calculator.vue", "vue", 0, 0, 9, 0, 0, 4, 13
"d:\Training-workspace\project-ws\loop-code-plus_vue_5\project\loop-code-plus-vue-5\src\view\Library\python\Python-class.vue", "vue", 0, 0, 9, 0, 0, 4, 13
"d:\Training-workspace\project-ws\loop-code-plus_vue_5\project\loop-code-plus-vue-5\src\view\Library\python\Python-comment.vue", "vue", 0, 0, 9, 0, 0, 4, 13
"d:\Training-workspace\project-ws\loop-code-plus_vue_5\project\loop-code-plus-vue-5\src\view\Library\python\Python-controller.vue", "vue", 0, 0, 9, 0, 0, 4, 13
"d:\Training-workspace\project-ws\loop-code-plus_vue_5\project\loop-code-plus-vue-5\src\view\Library\python\Python-dataStructure.vue", "vue", 0, 0, 9, 0, 0, 4, 13
"d:\Training-workspace\project-ws\loop-code-plus_vue_5\project\loop-code-plus-vue-5\src\view\Library\python\Python-error.vue", "vue", 0, 0, 9, 0, 0, 4, 13
"d:\Training-workspace\project-ws\loop-code-plus_vue_5\project\loop-code-plus-vue-5\src\view\Library\python\Python-inputAndOuput.vue", "vue", 0, 0, 9, 0, 0, 4, 13
"d:\Training-workspace\project-ws\loop-code-plus_vue_5\project\loop-code-plus-vue-5\src\view\Library\python\Python-install.vue", "vue", 0, 0, 31, 0, 0, 2, 33
"d:\Training-workspace\project-ws\loop-code-plus_vue_5\project\loop-code-plus-vue-5\src\view\Library\python\Python-interpreter.vue", "vue", 0, 0, 9, 0, 0, 4, 13
"d:\Training-workspace\project-ws\loop-code-plus_vue_5\project\loop-code-plus-vue-5\src\view\Library\python\Python-introduction.vue", "vue", 0, 0, 23, 0, 0, 4, 27
"d:\Training-workspace\project-ws\loop-code-plus_vue_5\project\loop-code-plus-vue-5\src\view\Library\python\Python-module.vue", "vue", 0, 0, 9, 0, 0, 4, 13
"d:\Training-workspace\project-ws\loop-code-plus_vue_5\project\loop-code-plus-vue-5\src\view\Library\python\Python-next.vue", "vue", 0, 0, 9, 0, 0, 4, 13
"d:\Training-workspace\project-ws\loop-code-plus_vue_5\project\loop-code-plus-vue-5\src\view\Library\python\Python-standardLibrary.vue", "vue", 0, 0, 9, 0, 0, 4, 13
"d:\Training-workspace\project-ws\loop-code-plus_vue_5\project\loop-code-plus-vue-5\src\view\Library\python\Python.vue", "vue", 0, 0, 108, 0, 0, 3, 111
"d:\Training-workspace\project-ws\loop-code-plus_vue_5\project\loop-code-plus-vue-5\src\view\Library\python\install\Install-Windows.vue", "vue", 0, 0, 731, 0, 0, 6, 737
"d:\Training-workspace\project-ws\loop-code-plus_vue_5\project\loop-code-plus-vue-5\src\view\PersonalCenter\info.vue", "vue", 0, 0, 419, 0, 0, 29, 448
"d:\Training-workspace\project-ws\loop-code-plus_vue_5\project\loop-code-plus-vue-5\src\view\Problem.vue", "vue", 0, 0, 407, 0, 0, 10, 417
"d:\Training-workspace\project-ws\loop-code-plus_vue_5\project\loop-code-plus-vue-5\src\view\Search.vue", "vue", 0, 0, 156, 0, 0, 7, 163
"d:\Training-workspace\project-ws\loop-code-plus_vue_5\project\loop-code-plus-vue-5\src\view\Store.vue", "vue", 0, 0, 255, 0, 0, 7, 262
"d:\Training-workspace\project-ws\loop-code-plus_vue_5\project\loop-code-plus-vue-5\src\view\problem\Collection.vue", "vue", 0, 0, 318, 0, 0, 11, 329
"d:\Training-workspace\project-ws\loop-code-plus_vue_5\project\loop-code-plus-vue-5\src\view\problem\SingCompetitionArea.vue", "vue", 0, 0, 639, 0, 0, 20, 659
"d:\Training-workspace\project-ws\loop-code-plus_vue_5\project\loop-code-plus-vue-5\src\view\problem\WorkingArea.vue", "vue", 0, 0, 588, 0, 0, 12, 600
"d:\Training-workspace\project-ws\loop-code-plus_vue_5\project\loop-code-plus-vue-5\src\view\tool\Achievement.vue", "vue", 0, 0, 626, 0, 0, 25, 651
"d:\Training-workspace\project-ws\loop-code-plus_vue_5\project\loop-code-plus-vue-5\src\view\tool\Backpack.vue", "vue", 0, 0, 268, 0, 0, 8, 276
"d:\Training-workspace\project-ws\loop-code-plus_vue_5\project\loop-code-plus-vue-5\src\view\tool\EditCollection.vue", "vue", 0, 0, 566, 0, 0, 14, 580
"d:\Training-workspace\project-ws\loop-code-plus_vue_5\project\loop-code-plus-vue-5\src\view\tool\EditProblem.vue", "vue", 0, 0, 376, 0, 0, 12, 388
"d:\Training-workspace\project-ws\loop-code-plus_vue_5\project\loop-code-plus-vue-5\src\view\tool\EditSolution.vue", "vue", 0, 0, 240, 0, 0, 12, 252
"d:\Training-workspace\project-ws\loop-code-plus_vue_5\project\loop-code-plus-vue-5\src\view\tool\LCPlab.vue", "vue", 0, 0, 43, 0, 0, 5, 48
"d:\Training-workspace\project-ws\loop-code-plus_vue_5\project\loop-code-plus-vue-5\src\view\tool\Login.vue", "vue", 0, 0, 284, 0, 0, 19, 303
"d:\Training-workspace\project-ws\loop-code-plus_vue_5\project\loop-code-plus-vue-5\src\view\tool\MyProblem.vue", "vue", 0, 0, 438, 0, 0, 12, 450
"d:\Training-workspace\project-ws\loop-code-plus_vue_5\project\loop-code-plus-vue-5\src\view\tool\MySolution.vue", "vue", 0, 0, 201, 0, 0, 4, 205
"d:\Training-workspace\project-ws\loop-code-plus_vue_5\project\loop-code-plus-vue-5\src\view\tool\PersonalCenter.vue", "vue", 0, 0, 1156, 0, 0, 57, 1213
"Total", "-", 569, 78, 10560, 14, 55, 447, 11723